Fungi_Must_1W12A	TTAGATCCTGATCCTCCGCTTATTGATATGC
Fungi_Must_1W12B	TTAGATGAGGATCCTCCGCTTATTGATATGC
Fungi_Must_1W13A	TTAGACTACGATCCTCCGCTTATTGATATGC
Fungi_Must_1W13B	TTAGACATGGATCCTCCGCTTATTGATATGC
Fungi_Must_1W17A	TTAGAGTCAGATCCTCCGCTTATTGATATGC
Fungi_Must_1W17B	TTAGCAGATGATCCTCCGCTTATTGATATGC
Fungi_Must_1GVA TTAGCCTGTGATCCTCCGCTTATTGATATGC
Fungi_Must_1GVB	TTAGGTACAGATCCTCCGCTTATTGATATGC
Fungi_Must_1OEA	TTAGGCGCCGATCCTCCGCTTATTGATATGC
Fungi_Must_1OEB	TTCTTATGGGATCCTCCGCTTATTGATATGC
Fungi_Must_1SA	TTCTTACTCGATCCTCCGCTTATTGATATGC
Fungi_Must_2W12A	TTCTTAGCAGATCCTCCGCTTATTGATATGC
Fungi_Must_2W12B	TTCTTCAGTGATCCTCCGCTTATTGATATGC
Fungi_Must_2W13A	TTCTTCGACGATCCTCCGCTTATTGATATGC
Fungi_Must_2W13B	TTCTTGAAGGATCCTCCGCTTATTGATATGC
Fungi_Must_2W17B	TTCTTGGTTGATCCTCCGCTTATTGATATGC
Fungi_Must_2GVA	TTCTATTCCGATCCTCCGCTTATTGATATGC
Fungi_Must_2GVB	TTCTATAGGGATCCTCCGCTTATTGATATGC
Fungi_Must_2OEA	TTCTAACAGGATCCTCCGCTTATTGATATGC
Fungi_Must_2SA	TTCTACCGAGATCCTCCGCTTATTGATATGC
Fungi_Must_2W17A	TTCTAGTTGGATCCTCCGCTTATTGATATGC
Fungi_Must_2OEB	TTCTAGCCTGATCCTCCGCTTATTGATATGC
Fungi_Must_3W12A	TTCTAGGAAGATCCTCCGCTTATTGATATGC
Fungi_Must_3W12B	TTCTCTTAGGATCCTCCGCTTATTGATATGC
Fungi_Must_3W13A	TTCTCTACAGATCCTCCGCTTATTGATATGC
Fungi_Must_3W13B	TTCTCTCTTGATCCTCCGCTTATTGATATGC
Fungi_Must_3W17A	TTCTCTGGCGATCCTCCGCTTATTGATATGC
Fungi_Must_3W17B	TTCTCCATCGATCCTCCGCTTATTGATATGC
Fungi_Must_3GVA	TTCTCCGCTGATCCTCCGCTTATTGATATGC
Fungi_Must_3GVB	TTCTCGTGAGATCCTCCGCTTATTGATATGC
Fungi_Must_3OEA	TTCTGTGTAGATCCTCCGCTTATTGATATGC
Fungi_Must_3SA	TTCTGAACCGATCCTCCGCTTATTGATATGC
Fungi_Must_4W13A	TTCTGACGTGATCCTCCGCTTATTGATATGC
Fungi_Must_4W13B	TTCTGCTCAGATCCTCCGCTTATTGATATGC
Fungi_Must_4W17A	TTCATTGTGGATCCTCCGCTTATTGATATGC
Fungi_Must_4W17B	TTCATCTTCGATCCTCCGCTTATTGATATGC
Fungi_Must_4GVA	TTCATGTCAGATCCTCCGCTTATTGATATGC
Fungi_Must_4GVB	TTCAGTTACGATCCTCCGCTTATTGATATGC
Fungi_Must_4OEA	TTCAGTCCTGATCCTCCGCTTATTGATATGC
Fungi_Must_5W12A	TTCAGATTGGATCCTCCGCTTATTGATATGC
Fungi_Must_3OEB	TTCAGAAGAGATCCTCCGCTTATTGATATGC
Fungi_Must_4W12A	TTCAGCTGTGATCCTCCGCTTATTGATATGC
Fungi_Must_4W12B	TTCAGGCTAGATCCTCCGCTTATTGATATGC
Fungi_Must_4OEB	TTCCTTCATGATCCTCCGCTTATTGATATGC
